













SO ./assets/so.xpm



EA ./assets/ea.xpm
WE ./assets/we.xpm


C 80,80,80
NO ./assets/no.xpm

F  50,50,50

1111111111111111111111111
1S00010000000010000000001
1011110111111110111110101
10000001000000001000000001
1111011101111111101111111
1000010001000000001000001
1011110111011111111011101
1000000001000000100000001
1111111111111101101111111
1000000000000100001000001
1011111111110111111011101
1000000000010000001000001
1111111011111111111111101
1000001000000000000000101
1011111011111111111111101
1000000010000000000000001
1111111111111111111111111