SO ./assets/so.xpm
EA ./assets/ea.xpm
WE ./assets/we.xpm
NO ./assets/nox.xpm

F 32,32,32
C 0,25,51

111111
100101
101001
1100N1
111111