













SO ./assets/so.xpm



EA                      ./assets/ea.xpm
                    WE                 ./assets/we.xpm  


NO ./assets/no.xpm

C 0,25,51
F  20,30,40

111111
100101
101001
1100N1
111111